1 13 31
###############################
#   p  s     1     *  * * *   #
# # # #*# # #*#*# # # #*#*#*# #
#f  *     ***3 *    s *   * * #
# # # # # #*# # #*#*# # # # #*#
#      b   x **  *  *         #
# # # # # # # # # #*# #*# # # #
#*  *      *  *      *   b    #
# # # # #*# # # #*#*# # # # # #
#*    **  *       *   b      b#
# #*# # # # # # #*# # # # # # #
#           *   *  *       3  #
###############################