3 13 31
###############################
#p  b *f* *  3 *  *  * * *    #
#************#****************#
#  x*     ***  *  1   * 2 * * #
# # # # # #*# # #*#*# # # # #*#
#s  s        **  *  *   1     #
# # # # # # # # # #*# #*# # # #
#*  *    2 *  *      *      s #
# # # # #*# # # #*#*# # # # # #
#*    **  *   2   *           #
# #*# # # # # # #*# # # # # # #
#           *   *  *      3   #
###############################