2 13 31
###############################
#p b f ** *  1 *   *  * * *   #
# # # #*# # #*#*# # # #*#*#*# #
#  x*     ***  *  1   *   * * #
# # # # # #*# # #*#*# # # # #*#
#s  s      x **  *  *         #
# # # # # # # # # #*# #*# # # #
#*  *      *  *      *      s #
# # # # #*# # # #*#*# # # # # #
#*    **  *       *           #
# #*# # # # # # #*# # # # # # #
#           *   *  *          #
###############################