2 13 31
###############################
#xp   **f*****b***************#
#     *3    3    3    3     3*#
#     b***********************#
#*b***************************#
#****s************************#
#s****************************#
#*****************************#
#*****************************#
#*****************************#
#*****************************#
#*****************************#
###############################